047 047 047 047 047 047 047 047 047 047 047 047 047 047 047 047 047 047 047 047 047 047 047 047 047 047 047 047 047 047 047 047
155 029 022 047 010 023 013 047 051 001 009 008 007 047 014 021 024 027 016 156 047 047 047 047 047 047 047 047 047 047 047 047
047 029 014 029 027 018 028 047 021 018 012 014 023 028 014 013 047 029 024 047 047 047 047 047 047 047 047 047 047 047 047 047
047 047 047 047 011 030 021 021 014 029 037 025 027 024 024 015 047 047 047 047 047 047 047 047 047 047 047 047 047 047 047 047
047 047 047 047 028 024 015 029 032 010 027 014 047 010 023 013 047 047 047 047 047 047 047 047 047 047 047 047 047 047 047 047
047 047 047 028 030 011 037 021 018 012 014 023 028 014 013 047 029 024 047 047 047 047 047 047 047 047 047 047 047 047 047 047
047 047 047 047 047 047 023 018 023 029 014 023 013 024 036 047 047 047 047 047 047 047 047 047 047 047 047 047 047 047 047 047
047 047 047 047 047 047 047 047 047 047 047 047 047 047 047 047 047 047 047 047 047 047 047 047 047 047 047 047 047 047 047 047
047 051 001 009 008 009 047 011 030 021 021 014 029 037 025 027 024 024 015 047 047 047 047 047 047 047 047 047 047 047 047 047
047 047 047 047 047 047 028 024 015 029 032 010 027 014 036 047 047 047 047 047 047 047 047 047 047 047 047 047 047 047 047 047
047 047 047 051 048 049 050 049 047 052 053 054 055 056 057 047 047 047 047 047 047 047 047 047 047 047 047 047 047 047 047 047
047 047 047 047 047 047 047 047 047 047 047 047 047 047 047 047 047 047 047 047 047 047 047 047 047 047 047 047 047 047 047 047
010 021 021 047 027 018 016 017 029 028 047 027 014 028 014 027 031 014 013 036 047 047 047 047 047 047 047 047 047 047 047 047
047 047 047 047 047 047 047 047 047 047 047 047 047 047 047 047 047 047 047 047 047 047 047 047 047 047 047 047 047 047 047 047
047 047 024 027 018 016 018 023 010 021 047 012 024 023 012 014 025 029 156 047 047 047 047 047 047 047 047 047 047 047 047 047
047 013 014 028 018 016 023 047 010 023 013 047 025 027 024 016 027 010 022 047 047 047 047 047 047 047 047 047 047 047 047 047
011 034 047 010 021 014 033 014 034 047 025 010 035 017 018 029 023 024 031 157 047 047 047 047 047 047 047 047 047 047 047 047
047 047 047 047 047 047 047 047 047 047 047 047 047 047 047 047 047 047 047 047 047 047 047 047 047 047 047 047 047 047 047 047
047 047 047 047 047 047 047 047 047 047 047 047 047 047 047 047 047 047 047 047 047 047 047 047 047 047 047 047 047 047 047 047
047 047 047 047 047 047 047 047 047 047 047 047 047 047 047 047 047 047 047 047 047 047 047 047 047 047 047 047 047 047 047 047
047 047 047 047 047 047 047 047 047 047 047 047 047 047 047 047 047 047 047 047 047 047 047 047 047 047 047 047 047 047 047 047
047 047 047 047 047 047 047 047 047 047 047 047 047 047 047 047 047 047 047 047 047 047 047 047 047 047 047 047 047 047 047 047
047 047 047 047 047 047 047 047 047 047 047 047 047 047 047 047 047 047 047 047 047 047 047 047 047 047 047 047 047 047 047 047
047 047 047 047 047 047 047 047 047 047 047 047 047 047 047 047 047 047 047 047 047 047 047 047 047 047 047 047 047 047 047 047
047 047 047 047 047 047 047 047 047 047 047 047 047 047 047 047 047 047 047 047 047 047 047 047 047 047 047 047 047 047 047 047
047 047 047 047 047 047 047 047 047 047 047 047 047 047 047 047 047 047 047 047 047 047 047 047 047 047 047 047 047 047 047 047
047 047 047 047 047 047 047 047 047 047 047 047 047 047 047 047 047 047 047 047 047 047 047 047 047 047 047 047 047 047 047 047
047 047 047 047 047 047 047 047 047 047 047 047 047 047 047 047 047 047 047 047 047 047 047 047 047 047 047 047 047 047 047 047
047 047 047 047 047 047 047 047 047 047 047 047 047 047 047 047 047 047 047 047 047 047 047 047 047 047 047 047 047 047 047 047
047 047 047 047 047 047 047 047 047 047 047 047 047 047 047 047 047 047 047 047 047 047 047 047 047 047 047 047 047 047 047 047
047 047 047 047 047 047 047 047 047 047 047 047 047 047 047 047 047 047 047 047 047 047 047 047 047 047 047 047 047 047 047 047
047 047 047 047 047 047 047 047 047 047 047 047 047 047 047 047 047 047 047 047 047 047 047 047 047 047 047 047 047 047 047 047
